xxxxxxxxxxxxx
x00000000000x
x0x0x0x0x0x0x
x00000000000x
x0x0x0x0x0x0x
x00000000003x
x0x0x0x0x0x0x
x00000000000x
x0x0x0x0x0x0x
x00000000000x
xxxxxxxxxxxxx
